##########################
#O                  X   O#
#   X                    #
#               ##########
######         ######
########            ############
#                       X     O#
#              ####            #
#OX P     ##########       #####
################################