             ###########
        #####       P   ######
  #######                    ######
  #              O        X       #
  #################################