#####
#  P#
#   #    ######
#   #    #    #
#   ######    #
#    X       O#
###############