########################
#                      ###
#####                    ######
    #                         #
    #############             ###########
                #                       #
                #                       #
                #                       #
                #                     ###
      ###########                  #################
     ##                                      X     #
     #                      ##                     #
     #                     ####                    #
     #               P    ######                   #
     ###############################################